NO   ./assets/texture/Brick0.xpm
SO       ./assets/texture/Wall2.xpm
WE ./assets/texture/Wall4.xpm
EA ./assets/texture/Wall5.xpm
  
F 256, 49, 1
C 135, 206, 235

111
1E1
1111