NO ./assets/texture/Brick0.xpm
SO ./assets/texture/Wall2.xpm
WE ./assets/texture/Wall4.xpm
EA ./assets/texture/Wall5.xpm

F 220,100,0
C 225,100,255

1111111111111111111111111
1000000000110000000000001
1011000001110000000000001
10010000000F00000000000011111111
111111111011000001110000000000001
100000000011000001110111111111111
11110111111111011100000010001
111101111111110111010100FFF01
11000000110101011100000010001
10000000000000001100000010001
10000000000000001101010010001
11000001110101011111011110N0111
11111111111111111111111111111111